################################
#>............................c#
#..............................#
#..............................#
#..............................#
#..............................#
#......##....##................#
#......##....##................#
#..............................#
#......##.........##...........#
#.......##########.............#
#..............................#
#..............................#
#......p.......................#
#.................g............#
#..............................#
#..............................#
#..............................#
#..............................#
#..............................#
#..............................#
#..............................#
#c............................<#
################################