#########################
#*......................#
#.......................#
#.......................#
#.......................#
#.......................#
#......##....##.........#
#......##....##.........#
#.......................#
#......##.........##....#
#.......##########......#
#.......................#
#...........p...........#
#.......................#
#.......................#
#.......................#
#.......................#
#......................<#
#########################